NO ./textures/color_stone.xpm
SO ./textures/purple_stone.xpm
EA ./textures/grey_stone.xpm
WE ./textures/blue_stone.xpm

C 135,206,235
F 139,69,19

     111111111111111111111
     101000001000000000001
     101010101011111110001
     100010100010000010001
11111111110111111101111111
100000001000101000000
101111101011101101111
101000001010100000101
101011111010111110101
101010001010100010101
101110101010101010101
100000101010001010001
111011101011111011101
100000101000100010001
101110101110101110111
101000100000100010101
101011111111111110101
100010000000000010001
101010111011111111101
1N1000001000000000001
111111111111111111111
